#####################################################################################################
#S  #         #   #     # # # #   # #       #       # # #   #     #   # #   #     # # #   #         #
### ##### ### ### # # # # # # ### # ##### ####### ### # ### # ####### # ### ##### # # ### # ### ### #
#   #       #   #   # #     # #   # #             #   # # #   #         #     # #   # # # # # # # # #
### ######### ### ######### # ### # ############# ### # # ### ####### ##### ### # # # # # # # ### ###
#         #       #       #   # #   #   #       # #   #   # # #   #   # # # # # # #       #       # #
### ##### ##### # ##### # # ### ### # ####### ### ### ### # # # ##### # # # # # ### ##### # ### ### #
# # #           # #     #   # #       # # # #   # # #   #   #   #   # # #     #   #     #     #     #
# ####### # ### ### ####### # ##### # # # # # ### # ### ### # ##### # # ##### ### # #################
#   # # # # # # # #   #   #       # #   #       #   #   # # # #   #   #       # #   # #   #   #     #
# ### # ### # ### ####### ### ####### # ##### ##### ### # # # # ### # ####### # ### # # ### ### #####
#   #       # #       #     # #     # #       # #     #   #     #   # #       #   #   # #   #   # # #
### # # ### # ### ######### # # ######### ### # # ### ### # ##### ########### ### # ### # ### ### # #
#     # #   #       #         # # #       #   # # #   # #   #   #   # #       # # #   #   #   # # # #
# ### # ####### # ########### # # ########### # ##### # ### # ### # # ####### # # # ### # ### # # # #
# #   # #       #         # # #     # #   # # # #     #   #   #   # # #     # # #   #   # # # #     #
# # ### ############### ### # ##### # ### # # # ##### ### # ### ##### ##### # # # ##### ### # ### # #
# # #   #               # # # # #   # # #     # # #       # # # # # # #                 # #       # #
# ### ### ### # ### ### # # # # ### # # ##### # # # ##### # # # # # # # # ### ####### ### # # #######
#   # #   #   # #   #     #             #   #       #       # #     #   # #   # # # # # #   # # # # #
# ### # ####### ##### # # ############# ### ####### # ##### # # ##### # ### # # # # ### ### ### # # #
# #   # #   # # #     # # #                     # # # #   #   # #   # # #   #   #   # #     # #     #
### ### ### # ### ##### # # # ### # ##### ### # # ##### ##### # # ############# ### # ##### # ### ###
# # #   # # # #     #   #   #   # # # #     # #           #       #       # #   # #   #       # # # #
# ####### # # ### ### ### ####### ### ### ##### # # ##### # # ##### ### ### ### # ### ##### ### # # #
#   # # #         # # #       #   #       #     # #   #   # #       # # #     # #   #   #     # #   #
### # # ####### # # ### # # ##### # ##### ##### ### ### # ### ####### ##### ### # ##### ### ### # ###
# # # #         # #   # # # #     # # #   #     #   #   #     # # #   # #     # #   #   # # # # # # #
# # # ##### # # # # # # ### ### ### # ### ### ##### ######### # # ### # ##### # ### # ### # # # # # #
# #   #     # # # # #   #     # # # # #   #     #   # # #     # # #   # # # # # # #     #   #   # # #
# ### # ### # ############# ##### ### # ############# # # # # # # # # # # # # # # # ####### # ### # #
#       #   # # #           #         # #       # #     # # #   # # # # # # # #     #     #   #   # #
########### ### # # # ##### # ####### ### ##### # ### ### ### ### ### # # # # ##### ##### ### ### # #
#           #     # # #     # #   # #   # # #         #   #   # #   # # # # #   # # #     # #       #
# ### # # ########### ##### ##### # ### ### ### # ### # ##### # # ### # # # ### # # ##### # # # ### #
# #   # #   #   #     #   # #               # # # # # # #       # # # #       # # #   # # # # # # # #
####### # # ### # ### ### # ##### # # ##### # ##### # # # ### # # # # ####### # # # ### # # # ### ###
#       # # # #   #   # #     #   # # #                 # #   #   # # #     # # # # # # #   # #     #
### ######### ### ##### # ### ##### ####### ############### ##### # # ##### # # # # # # # # # ##### #
#   #   #         # # #   #     # # #     # #   #           #           #     #     #   # #       # #
####### ########### # # ### ##### ### ### # ### ### ########### ####### ### ### ####### ##### ##### #
#   #   # #   #   #   # #   # #     # #     # #     #         # #               # # #   # # # #     #
# ##### # ### # ##### ####### # ########### # ### ########### # ####### # # ### # # # ### # # ### ###
#       #       #     #     # #       #     #       # #       # #       # # # #   #   # #         # #
####### ### ######### # ### # ####### ####### ### ### ### # # # # ##### ##### ### ### # ### ####### #
#   # # # #   #   #     # # #   # #   #     # # # #     # # #   #   #   #       #   # # #   #     # #
# ### # # # ##### ####### # ### # # ####### # # ### ### ##### # ####### ### ### ### # # ### ### ### #
# # # # #   #   # # # #     # #     # #     # #     #   #     # #   # # # # # # #       # # #   #   #
# # # # ### # ### # # ##### # ### ### ##### ### ##### # ######### ### ### ### # # ### ### # ### # ###
#     #         # # #           #   #   #       #     # #   #   #       #       # #       # # #     #
### # # ##### ### # ######### # ### # ##### # # ### # # ### ### # # ### ####### ##### # ### # # #####
#   #   #   # #   #   # # #   #         #   # #   # # #           #   #   #     #   # #   # #     # #
########### # ### # # # # ####### ##### ### ### ##### # ##### ##### ### # ### # ### ### ### # ### # #
#     #   #         #     #       #           # # #   # #     #       # #     #   #   # # # #   #   #
##### # ##### # # ####### ### ######### ######### ####### ############### # # ### ### # # # # #######
#       #   # # # #           #       # # #   # # # #   # # #         #   # # # #                   #
####### ### ### ### ######### # ##### ### # # # # # # ### # # ####### # ####### ### ### ### ### #####
#               #   #         # #           #     #       #   #     # # #     #     #   #     # # # #
# ##### # ### ####### # ################# ####### # ############### # ####### ######### ### ### # # #
#   #   # #     #   # # # #         # #   # # # # # # # #     # #                       #     #     #
# ##### ##### ##### # ### ### # ### # ##### # # # ### # ### # # ##### # ### # # # ######### # ### ###
#   #       # #         # #   # # # #   #     #   # #   # # # #   #   # # # # # #   #       #   #   #
################### # ### # # ### # ### # ### # ### ### # ### ### ####### # # # ##### # # ### #######
#       #           # #     # #     # # # # # # #   #                   #   # #   #   # #   #       #
##### ########### ######### ####### # # # # # # # ##### # ######### # ####### ### ##### # ### # # # #
# # #   #   #     #     #   # #           #         # # # #         #     #   #   #     #   # # # # #
# # # ##### ### ##### # ##### ##### ####### # ### ### ####### ##### ##### ### ######### # # ####### #
#   #   #   #   # # # #             #       # # # #   # #     # # # # # #     #         # #       # #
### ### ### ##### # ### ######### # ########### # ### # ####### # # # # ##### # # # # # # # # # # # #
# #         # #       # # #   #   # # #                     # # # # #         # # # # # # # # # # # #
# # ### ### # # # # ##### ### ### ### # # ##### # ######### # # # ##### # # # # # ##### ### ### # ###
# # #     #     # #     # #       # # # # # #   # #           #         # # # # # #     #     # #   #
# ######### # ######### # ######### # ##### ######### ####### # ######### ### # ##### # ### ##### ###
# #     #   # #               #   #           # #     # #   #   #         #   # #     #   #   #     #
# # ######### ############### # # ##### # # # # ### ### ### ### ##### # ##### ##### ####### # ### # #
#     #   # # # #   # #   #     # # # # # # # #   # #   #       #     #   #   #   # #     # # # # # #
# ### ### # ### ### # # # ##### ### # ##### # ### ##### ### ### ### # ####### # ####### ### # # #####
# # #   #   # # #       # #     #   #       #               #   #   #   #       #           #       #
# # # ##### # # ##### # # ##### # # ########### ### # # ##### ####### ####### ####### ### ### ### # #
# #               # # # #     #   # # #   #     #   # # #       #       # #       # # # #   # #   # #
############### ### # ##### # ### ### ### ### # ### ### ##### ### ### ### # # # ### ### # ### ### ###
#         # #   #   # #     #     #   #   # # # # # #   #     #   #     #   # #   #         # # #   #
######### # ### ### ##### ### # # ### ### # ##### ### # ##### ####### ### # # # ##### # # ##### # # #
# # # # #   #       #   # #   # #   #   # #     #     #   #     #       # # # # # #   # #     #   # #
# # # # ### ### # # ### ##### ### ### ### ##### ##### # ### ######### ##### ##### ####### ####### ###
# #   #         # #   # #   # #   #                   # #   # # # # # #     #         # # #         #
# # ######### # ##### # # ####### ### # # ### # ### ### # ### # # # # # # # ### ### ### # ##### # ###
#         #   # #       #   #   #     # # #   #   # #   # #           # # # #   #         #     # # #
# # ##### # # ### # ### # # # # # ### # ##### ##### # # ##### ### ### ### ##### ### # # # ### ### # #
# # # #     # #   # #     #   #   #   # #   # #     # # #     #   # # #       # #   # # #   # #     #
### # ##### # ##### ### ##### # ### # ##### # # ##### ### # ### # # # ### # ##### # ##### ### ### ###
#   #       # #   # #   #     # #   #   # #   #     # #   # #   # #     # # #     #   # # #   #     #
##### ### ####### # ### ### ### # # # ### # ####################### # ### # ### # # # # ##### ### # #
#   #   #   #       # # #   #   # # # #               # #           # #   # #   # # # # #       # # #
# # # ### ### ####### # ### # # # ####### # # ### ### # ##### ##### ##### # ### # # ### # ##### #####
# # # #   #     #       #   # # # #       # # #     # # # #   #   #   #   # #   # # #     #         #
### ##### ##### # # ### ### ##### ####### # # ##### ### # ### ### # ##### ############# # ##### ### #
#           # # # # #   # # #   #   #   # # #   #     #       #       # #     # #       #   #     # #
# # # # # ### # ##### ### # # ### ##### # # # ### ######### # # # # ### # # ### ####### ### # # # # #
# # # # #   #       # #     #     #       # # #     #       # # # #   #   # #             # # # # #E#
#####################################################################################################
